1111131111
1010000001
1010001101
1000000001
1100000011
1001000021
1002001141
1100001001
1099999901
1111111111