1111151111
1210000121
1010000101
1000000001
1121000011
1001000041
1000001001
1209090901
1090909901
1111111111