1111151111
1210000121
1010000101
1000000001
1121000011
1001000001
1400001001
1209090901
1090909901
1111111111