1111151111
1210000001
1010001101
1000000021
1100000011
1001000021
1002001141
1100001001
1099999901
1111111111