1111151111
1210000141
1010000101
1000000101
1210000001
1001000021
1000001101
1009090901
1090909001
1111111111